1111111111111
1000000000001
1000000000001
1000P00000001
10000000C0001
10000C0000001
1E00000000001
1111111111111
