1111111111111
1F0C10000C0C1
1000101011111
1C10P01000001
1111000000001
10F00010F00E1
1110011011C11
1FC0000000001
1100CC00000C1
1FC0C0FFFC0C1
1111111111111
